. . . . . . . . . . . . . . . . . . . . . 
. . . . . . X X X X X X X X X . . . . . . 
. . . . . . X X X X X X X X X . . . . . . 
. . . . . . X X X X X X X X X . . . . . . 
. . . . . . X X X X b X X X X . . . . . . 
. . . . . . X X X X X X X X X . . . . . . 
. X X X X X X X X X X X X X X X X X X X . 
. X X X X X X X X X X X X X X X X X X X . 
. X X X X X X X X X X X X X X X X X X X . 
. X X X b X X X X X X X X X X X X X X X . 
. X X X X X X X X X X X X X X X X X X X . 
. X X X X X X X X X X X X X X X X X X X . 
. X X X X X X X X X X X X X X X X X X X . 
. X X X X X X X X X X X X X X X X X X X . 
. X X X X X X X X X X X X X X X X X X X . 
. . . . . . X X X X X X X X X . . . . . .
. . . . . . X X X X b X X X X . . . . . .
. . . . . . X X X X X X X X X . . . . . .
. . . . . . X X X X X X X X X . . . . . .
. . . . . . X X X X X X X X X . . . . . .
. . . . . . . . . . . . . . . . . . . . . 